border_size=1
usage=map

Wo          ,Wo          , Wo          , Wo          , Wo          , Wo          , Ww          , Wo          , Ww          , Wo          , Ww          , Wo          , Ww          , Wo          , Wo          , Wo          , Wo          , Wo          , Wo          , Wo          , Wo          , Wo          
Wo          ,Wo          , Wo          , Wo          , Wo          , Wo          , Ww          , Wo          , Ww          , Wo          , Ww          , Wo          , Ww          , Wo          , Wo          , Wo          , Wo          , Wo          , Wo          , Wo          , Wo          , Wo          
Wo          ,Wo          , Wo          , Wo          , Wo          , Wo          , Ww          , Ww          , Ds          , Ww          , Ww          , Ww          , Ww          , Ww          , Ww          , Wo          , Ww          , Wo          , Ww          , Wo          , Wo          , Wo          
Wo          ,Wo          , Wo          , Ww          , Ww          , Ww          , Ds          , Ds          , Ch          , Ds          , Ds          , Ds          , Ds          , Ds          , Ds          , Ww          , Ds          , Ww          , Ww          , Wo          , Wo          , Wo          
Wo          ,Wo          , Wo          , Wo          , Ww          , Ds          , Ch          , Ch          , Gs^Fp       , Ch          , Ch          , Ch          , Ch          , Ch          , Ch          , Ds          , Ch          , Ds          , Ds          , Ww          , Wo          , Wo          
Wo          ,Wo          , Wo          , Wo          , Ww          , Ds          , Ch          , Gg^Ve       , Rr          , Hh          , Gg          , Gs^Fp       , Gg^Ve       , Gs^Fp       , Gg          , Ch          , Gg^Ve       , Ch          , Ds          , Ww          , Wo          , Wo          
Wo          ,Wo          , Wo          , Ww          , Ww          , Ds          , Ch          , Rr          , Gs^Fp       , Rr          , Rr          , Rr          , Rr          , Rr          , Rr          , Rr          , Rr          , Ch          , Ds          , Ww          , Wo          , Wo          
Wo          ,Wo          , Wo          , Ww          , Ww          , Ds          , Ch          , Rr          , Hh          , Gs^Fp       , Gs^Fp       , Gs^Fp       , Rr          , Hh          , Hh          , Gs^Fp       , Rr          , Ch          , Ds          , Ww          , Wo          , Wo          
Wo          ,Wo          , Wo          , Ww          , Ds          , Ds          , Ch          , Rr          , Rr          , Hh          , Gs^Fp       , Ch          , 4 Kh        , Ch          , Hh          , Hh          , Rr          , Ch          , Ds          , Ww          , Wo          , Wo          
Wo          ,Wo          , Wo          , Ww          , Ds          , Ch          , Gg^Ve       , Gg          , Rr          , Gs^Fp       , Gs^Fp       , Ch          , Ch          , Ch          , Gs^Fp       , Rr          , Gg          , Ch          , Ds          , Ww          , Wo          , Wo          
Wo          ,Wo          , Wo          , Ww          , Ds          , Ch          , Ch          , Rr          , Gs^Fp       , Hh          , Hh          , Gg          , Rr          , Gg          , Hh          , Rr          , Gs^Fp       , Ch          , Ds          , Ww          , Wo          , Wo          
Wo          ,Wo          , Wo          , Ww          , Ww          , Ds          , Ch          , Rr          , Rr          , Hh          , Gs^Fp       , Hh          , Rr          , Rr          , Rr          , Rr          , Gg^Ve       , Ch          , Ds          , Ww          , Wo          , Wo          
Wo          ,Wo          , Wo          , Ww          , Ww          , Ds          , Ch          , Gg^Ve       , Hh          , Rr          , Rr          , Rr          , Gg^Ve       , Hh          , Hh          , Gs^Fp       , Ch          , Ch          , Ds          , Ww          , Wo          , Wo          
Wo          ,Wo          , Wo          , Wo          , Ww          , Ds          , Ds          , Ch          , Ch          , Gg          , Ch          , Gs^Fp       , Ch          , Gs^Fp       , Ch          , Gg          , Ch          , Ds          , Ww          , Ww          , Wo          , Wo          
Wo          ,Wo          , Wo          , Wo          , Ww          , Ww          , Ds          , Gg          , Gg          , Ch          , Gg          , Ch          , Gg          , Ch          , Gg          , Ch          , Hh          , Ds          , Ww          , Wo          , Wo          , Wo          
Wo          ,Wo          , Wo          , Wo          , Wo          , Ww          , Ww          , Ds          , Gg          , Gg          , Hh          , Gg          , Gg          , Gg          , Gg          , Gg          , Hh          , Ds          , Ds          , Ww          , Wo          , Wo          
Wo          ,Wo          , Wo          , Wo          , Wo          , Wo          , Ww          , Ds          , Hh          , Hh          , Gg          , Gg          , Gs^Fp       , Gg          , Gs^Fp       , Gg          , Gg          , Hh          , Ds          , Ww          , Wo          , Wo          
Wo          ,Wo          , Wo          , Wo          , Ww          , Wo          , Ww          , Ds          , Hh          , Hh          , Hh          , Gg          , Gs^Fp       , Gs^Fp       , Hh          , Gs^Fp       , Gg          , Ds          , Ww          , Ww          , Wo          , Wo          
Wo          ,Wo          , Wo          , Wo          , Wo          , Ww          , Ds          , Ds          , Gg          , Hh          , Gg          , Gg          , Gs^Fp       , Hh          , Gg          , Gg^Ve       , Gg          , Ds          , Ww          , Wo          , Wo          , Wo          
Wo          ,Wo          , Wo          , Wo          , Ww          , Ww          , Ds          , Gg          , Gg          , Gg          , Gg          , Gs^Fp       , Gg          , Hh          , Gg          , Gg          , Ds          , Ds          , Ww          , Ww          , Wo          , Wo          
Wo          ,Wo          , Wo          , Wo          , Ww          , Ww          , Ds          , Hh          , Hh          , Gg          , Gg          , Gs^Fp       , Gg          , Gg          , Hh          , Gs^Fp       , Ds          , Ww          , Ww          , Ww          , Wo          , Wo          
Wo          ,Wo          , Wo          , Ww          , Ww          , Ds          , Gg^Ve       , Hh          , Gg          , Gg          , Gg          , Gg          , Gg^Ve       , Hh          , Gs^Fp       , Gs^Fp       , Ds          , Ww          , Ww          , Wo          , Wo          , Wo          
Wo          ,Wo          , Wo          , Wo          , Ww          , Ds          , Gs^Fp       , Hh          , Gs^Fp       , Gg          , Gg          , Gg          , Gg          , Hh          , Gs^Fp       , Gs^Fp       , Gs^Fp       , Ds          , Ww          , Wo          , Wo          , Wo          
Wo          ,Wo          , Ww          , Wo          , Ww          , Ds          , Hh          , Gs^Fp       , Hh          , Gs^Fp       , Gs^Fp       , Gg          , Gg          , Gs^Fp       , Ds          , Ds          , Ds          , Ds          , Ww          , Wo          , Wo          , Wo          
Wo          ,Wo          , Ww          , Ww          , Ww          , Ds          , Ds          , Gs^Fp       , Hh          , Hh          , Gs^Fp       , Gg          , Gg          , Gg          , Ds          , Ww          , Ww          , Ww          , Wo          , Wo          , Wo          , Wo          
Wo          ,Wo          , Wo          , Wo          , Ww          , Ww          , Ds          , Gg          , Gg          , Hh          , Gs^Fp       , Gg          , Hh          , Gg          , Hh          , Ds          , Ds          , Ww          , Ww          , Wo          , Wo          , Wo          
Wo          ,Wo          , Wo          , Wo          , Ww          , Ds          , Hh          , Gg          , Gg          , Gg          , Gs^Fp       , Gg          , Hh          , Hh          , Gs^Fp       , Gs^Fp       , Gs^Fp       , Ds          , Ds          , Ww          , Wo          , Wo          
Wo          ,Wo          , Wo          , Ww          , Ds          , Ds          , Hh          , Hh          , Gg          , Gg          , Gg          , Gg          , Gg          , Hh          , Hh          , Gg^Ve       , Gs^Fp       , Gs^Fp       , Ds          , Ww          , Wo          , Wo          
Wo          ,Wo          , Ww          , Ww          , Ds          , Hh          , Gs^Fp       , Gg^Ve       , Gg          , Ce          , Ce          , Gg          , Gs^Fp       , Gs^Fp       , Hh          , Gs^Fp       , Ds          , Ds          , Ww          , Ww          , Wo          , Wo          
Wo          ,Wo          , Wo          , Ww          , Ds          , Gs^Fp       , Gs^Fp       , Gs^Fp       , Gs^Fp       , 5 Ke        , Gg          , Hh          , Hh          , Gs^Fp       , Gs^Fp       , Gs^Fp       , Ds          , Ww          , Ww          , Ww          , Wo          , Wo          
Wo          ,Wo          , Ww          , Ww          , Ds          , Gs^Fp       , Gs^Fp       , Gs^Fp       , Gs^Fp       , Gs^Fp       , Gg          , Gg          , Hh          , Gg          , Gs^Fp       , Ds          , Ww          , Ww          , Wo          , Wo          , Wo          , Wo          
Wo          ,Wo          , Wo          , Ww          , Ww          , Ds          , Hh          , Gs^Fp       , Gs^Fp       , Gs^Fp       , Gg          , Gg          , Gg          , Gg          , Gs^Fp       , Ds          , Ds          , Ww          , Wo          , Wo          , Wo          , Wo          
Wo          ,Wo          , Ww          , Ww          , Ww          , Ds          , Hh          , Gs^Fp       , Gg^Ve       , Gg          , Hh          , Gg          , Gg          , Hh          , Gs^Fp       , Gs^Fp       , Ds          , Ww          , Wo          , Wo          , Wo          , Wo          
Wo          ,Wo          , Wo          , Ww          , Ds          , Ds          , Gg          , Hh          , Hh          , Hh          , Hh          , Hh          , Hh          , Hh          , Gs^Fp       , Ds          , Ww          , Ww          , Wo          , Wo          , Wo          , Wo          
Wo          ,Wo          , Wo          , Ww          , Ds          , Gg          , Gg          , Gg          , Gg          , Gg          , Gg          , Gs^Fp       , Gs^Fp       , Gs^Fp       , Ds          , Ds          , Ww          , Ww          , Wo          , Wo          , Wo          , Wo          
Wo          ,Wo          , Ww          , Ww          , Ds          , Gg          , Hh          , Gg          , Gg^Ve       , Gg          , Gs^Fp       , Hh          , Gs^Fp       , Gs^Fp       , Ds          , Ww          , Ww          , Wo          , Ww          , Wo          , Wo          , Wo          
Wo          ,Wo          , Ww          , Ds          , Hh          , Hh          , Gs^Fp       , Hh          , Hh          , Gs^Fp       , Gs^Fp       , Gs^Fp       , Ds          , Ds          , Ww          , Ww^Bw\      , Ds          , Ds          , Ds          , Ww          , Ww          , Ww          
Wo          ,Wo          , Ww          , Ds          , Hh          , Hh          , Gs^Fp       , Gs^Fp       , Ds          , Ds          , Ds          , Gs^Fp       , Ds          , Wo          , Wo          , Ww          , Ds          , Gg^Ve       , Gg          , Ds          , Ww          , Ww          
Wo          ,Wo          , Ww          , Ds          , Ds          , Gs^Fp       , Gs^Fp       , Gs^Fp       , Ds          , Ww          , Ww          , Ds          , Ww          , Wo          , Ds          , Ds          , Gs^Fp       , Gs^Fp       , Gg          , Ds          , Ww          , Ww          
Wo          ,Wo          , Wo          , Ww          , Ds          , Gs^Fp       , Ds          , Ds          , Ww          , Ww          , Wo          , Ww^Bw|      , Wo          , Wo          , Ds          , Gs^Fp       , Hh          , Gg          , Hh          , Ds          , Ww          , Ww          
Ww          ,Ww          , Wo          , Wo          , Ww          , Ds          , Wo          , Ww          , Wo          , Wo          , Ww          , Ww^Bw|      , Ww          , Ww          , Ww          , Ds          , Ds          , Gg          , Gs^Fp       , Ds          , Ww          , Ww          
Ww          ,Ww          , Wo          , Ww          , Wo          , Ww^Bw|      , Ww          , Wo          , Ww          , Ww          , Ds          , Ds          , Ds          , Ww          , Wo          , Wo          , Ds          , Gg^Ve       , Ds          , Ds          , Ww          , Ww          
Wo          ,Wo          , Ww          , Wo          , Ds          , Ds          , Ds          , Ww          , Ww          , Ds          , Ch          , Ch          , Ch          , Ds          , Ds          , Ww^Bw/      , Wo          , Ds          , Ww          , Ww          , Wo          , Wo          
Wo          ,Wo          , Ww          , Ds          , Ch          , Ch          , Ch          , Ds          , Ds          , Ds          , Ch          , Gg^Ve       , Gg          , Ch          , Ds          , Wo          , Wo          , Ww          , Wo          , Wo          , Wo          , Wo          
Ww          ,Ww          , Ds          , Ds          , Ch          , Gg^Ve       , Gs^Fp       , Ch          , Ch          , Ch          , Gs^Fp       , Rr          , Hh          , Ch          , Ds          , Ww          , Ww          , Wo          , Ww          , Wo          , Wo          , Wo          
Ww          ,Ww          , Ds          , Ch          , Gg          , Rr          , Gs^Fp       , Gs^Fp       , Hh          , Gg          , Rr          , Rr          , Rr          , Ch          , Ch          , Ds          , Ds          , Ww          , Ww          , Wo          , Wo          , Wo          
Ww          ,Ww          , Ds          , Ch          , Ch          , Rr          , Rr          , Gs^Fp       , Rr          , Rr          , Gs^Fp       , Gs^Fp       , Rr          , Gs^Fp       , Gg^Ve       , Ch          , Ds          , Ww          , Wo          , Wo          , Wo          , Wo          
Ww          ,Ww          , Ww          , Ds          , Ds          , Ch          , Gg^Ve       , Rr          , Gs^Fp       , Ch          , 3 Kh        , Ch          , Rr          , Gs^Fp       , Rr          , Ch          , Ds          , Ww          , Wo          , Wo          , Wo          , Wo          
Wo          ,Wo          , Ww          , Ww          , Ds          , Ch          , Ch          , Gs^Fp       , Hh          , Hh          , Ch          , Gs^Fp       , Rr          , Hh          , Rr          , Ch          , Ds          , Ww          , Ww          , Wo          , Wo          , Wo          
Wo          ,Wo          , Ww          , Ds          , Gg          , Gg          , Gg          , Ch          , Ch          , Gg          , Ch          , Gg^Ve       , Rr          , Hh          , Rr          , Ch          , Ch          , Ds          , Ww          , Wo          , Wo          , Wo          
Wo          ,Wo          , Ww          , Ds          , Gs^Fp       , Gs^Fp       , Gg          , Gg          , Gg          , Ch          , Gg          , Ch          , Ch          , Rr          , Gg          , Gg^Ve       , Ch          , Ds          , Ww          , Wo          , Wo          , Wo          
Ww          ,Ww          , Ds          , Ds          , Gg^Ve       , Gs^Fp       , Gs^Fp       , Gg          , Gg          , Gg          , Gg          , Gg          , Gg          , Ch          , Ch          , Ch          , Gg          , Ds          , Ww          , Wo          , Wo          , Wo          
Ww          ,Ww          , Ds          , Gg          , Gg          , Gs^Fp       , Gg          , Gg          , Hh          , Gg          , Gg          , Gs^Fp       , Gs^Fp       , Gg          , Gg          , Gg          , Hh          , Ds          , Ww          , Wo          , Wo          , Wo          
Ww          ,Ww          , Ww          , Ds          , Ds          , Gg          , Gg          , Hh          , Hh          , Gg          , Gg          , Gs^Fp       , Gg          , Gs^Fp       , Gs^Fp       , Gg          , Ds          , Ds          , Ww          , Wo          , Wo          , Wo          
Wo          ,Wo          , Wo          , Ww          , Ww          , Ds          , Gg          , Gg          , Gg          , Gg          , Gs^Fp       , Gg          , Gg          , Gg          , Gg          , Ds          , Ww          , Ww          , Wo          , Wo          , Wo          , Wo          
Wo          ,Wo          , Wo          , Wo          , Ww          , Ds          , Ds          , Gg          , Gs^Fp       , Gs^Fp       , Gg^Ve       , Gs^Fp       , Gs^Fp       , Hh          , Gg          , Ds          , Ds          , Ww          , Wo          , Wo          , Wo          , Wo          
Wo          ,Wo          , Wo          , Wo          , Wo          , Ww          , Ds          , Gg          , Hh          , Gg          , Gg          , Gg          , Gs^Fp       , Hh          , Hh          , Gg          , Ds          , Ww          , Ww          , Wo          , Wo          , Wo          
Wo          ,Wo          , Wo          , Wo          , Wo          , Ww          , Ds          , Hh          , Hh          , Hh          , Gg          , Gg          , Gg          , Gg          , Gg          , Hh          , Gg^Ve       , Ds          , Ww          , Wo          , Wo          , Wo          
Wo          ,Wo          , Wo          , Wo          , Ww          , Ww          , Ww          , Ds          , Gg          , Gg          , Gg          , Gs^Fp       , Gs^Fp       , Gs^Fp       , Gg          , Gg          , Gg          , Ds          , Ww          , Wo          , Wo          , Wo          
Wo          ,Wo          , Ww          , Ww          , Ds          , Ds          , Ds          , Ds          , Gs^Fp       , Gs^Fp       , Gg          , Gg          , Gg          , Gs^Fp       , Gs^Fp       , Gg          , Gg          , Ds          , Ww          , Ww          , Ww          , Ww          
Ww          ,Ww          , Ds          , Ds          , Gs^Fp       , Gg          , Gg          , Gg          , Gs^Fp       , Gs^Fp       , Hh          , Gg^Ve       , Gg          , Gg          , Gg          , Gg          , Gs^Fp       , Ds          , Ds          , Ww          , Ww          , Ww          
Ds          ,Ds          , Gs^Fp       , Gs^Fp       , Gs^Fp       , Gg          , Ce          , Gg          , Gs^Fp       , Gs^Fp       , Hh          , Hh          , Gg          , Gg          , Gs^Fp       , Gs^Fp       , Ce          , Gs^Fp       , Gs^Fp       , Ds          , Ds          , Ds          
Gs^Fp       ,Gs^Fp       , Gs^Fp       , Gs^Fp       , Gs^Fp       , Ce          , Ce          , Gg          , Gg          , Gg          , Gg          , Gg          , Gg          , Gg          , Hh          , Hh          , Ce          , Ce          , Gs^Fp       , Gs^Fp       , Gs^Fp       , Gs^Fp       
Gs^Fp       ,Gs^Fp       , Gg^Ve       , Gs^Fp       , Gs^Fp       , 1 Ke        , Gs^Fp       , Gs^Fp       , Hh          , Hh          , Gs^Fp       , Gg          , Gs^Fp       , Hh          , Hh          , Hh          , Gs^Fp       , 2 Ke        , Gs^Fp       , Gg^Ve       , Gs^Fp       , Gs^Fp       
Gs^Fp       ,Gs^Fp       , Gs^Fp       , Gs^Fp       , Gs^Fp       , Hh          , Hh          , Hh          , Hh          , Hh^Vhh      , Hh          , Gs^Fp       , Gs^Fp       , Hh^Vhh      , Hh          , Hh          , Hh          , Hh          , Gs^Fp       , Gs^Fp       , Gs^Fp       , Gs^Fp       
Gs^Fp       ,Gs^Fp       , Gs^Fp       , Gs^Fp       , Gs^Fp       , Hh          , Hh          , Hh          , Hh          , Hh      , Hh          , Gs^Fp       , Gs^Fp       , Hh      , Hh          , Hh          , Hh          , Hh          , Gs^Fp       , Gs^Fp       , Gs^Fp       , Gs^Fp       
